------------------------------------------------------------------
-                                                                -
-                                                                -
-                                                                -
-                                                                -
-                                                                -
-                                                                -
-                                                                -
-                                                                -
-                                                                -
-                              Y                                 -
-                                                                -
-                                                                -
-                                                                -
-                                                                -
-                                                                -
-                                                                -
-                                                                -
-                                                                -
-                                                                -
-                                                                -
-                                                                -
---------------------------------------------------------------  -
-                                                                -
-------- ------------------------------------------------------ --
-                                                                -
---------------------------- -------------------------------------
-                                                                -
-   --------------------------------------------------------------
-                                                                -
-------------------------------------------------------------    -
-                                                                -
------------------------------------------------------------------
